long (long)	{{c1::lange}}	Je m’efforçai donc d’en savoir plus <b><u>long</u></b> : –    D’où viens-tu, mon petit bonhomme ? <br>
intrigué (intrigue)	{{c1::Handlung}}	Vous imaginez combien j’avais pu être <b><u>intrigué</u></b> par cette demi-confidence sur « les autres planètes ». <br>
trésor (trésor)	{{c1::Schatz}}	Puis, sortant mon mouton de sa poche, il se plongea dans la contem- plation de son <b><u>trésor</u></b>. <br>
efforçai (efforcer)	{{c1::streben}}	Je m’<b><u>efforçai</u></b> donc d’en savoir plus long : –    D’où viens-tu, mon petit bonhomme ? <br>
confidence (confidence)	{{c1::Vertrauen}}	Vous imaginez combien j’avais pu être intrigué par cette demi-<b><u>confidence</u></b> sur « les autres planètes ». <br>
plongea (plonger)	{{c1::tauchen}}	Puis, sortant mon mouton de sa poche, il se <b><u>plongea</u></b> dans la contem- plation de son trésor. <br>
Puis (puis)	{{c1::dann}}	<b><u>Puis</u></b>, sortant mon mouton de sa poche, il se plongea dans la contem- plation de son trésor. <br>
sortant (sortant)	{{c1::ausgehen}}	Puis, <b><u>sortant</u></b> mon mouton de sa poche, il se plongea dans la contem- plation de son trésor. <br>
rêverie (rêverie)	{{c1::Träumereien}}	Il hochait la tête doucement tout en regardant mon avion : –    C’est vrai que, là-dessus, tu ne peux pas venir de bien loin… Et il s’enfonça dans une <b><u>rêverie</u></b> qui dura longtemps. <br>
enfonça (enfoncer)	{{c1::einpressen}}	Il hochait la tête doucement tout en regardant mon avion : –    C’est vrai que, là-dessus, tu ne peux pas venir de bien loin… Et il s’<b><u>enfonça</u></b> dans une rêverie qui dura longtemps. <br>
dessus (dessus)	{{c1::über}}	Il hochait la tête doucement tout en regardant mon avion : –    C’est vrai que, là-<b><u>dessus</u></b>, tu ne peux pas venir de bien loin… Et il s’enfonça dans une rêverie qui dura longtemps. <br>
loin (loin)	{{c1::weit}}	Il hochait la tête doucement tout en regardant mon avion : –    C’est vrai que, là-dessus, tu ne peux pas venir de bien <b><u>loin</u></b>… Et il s’enfonça dans une rêverie qui dura longtemps. <br>
hochait (hocher)	{{c1::nicken}}	Il <b><u>hochait</u></b> la tête doucement tout en regardant mon avion : –    C’est vrai que, là-dessus, tu ne peux pas venir de bien loin… Et il s’enfonça dans une rêverie qui dura longtemps. <br>
mystère (mystère)	{{c1::Geheimnis}}	J’entrevis aussitôt une lueur, dans le <b><u>mystère</u></b> de sa pré- sence, et j’interrogeai brusquement : –    Tu viens donc d’une autre planète ? <br>
lueur (lueur)	{{c1::glühen}}	J’entrevis aussitôt une <b><u>lueur</u></b>, dans le mystère de sa pré- sence, et j’interrogeai brusquement : –    Tu viens donc d’une autre planète ? <br>
aussitôt (aussitôt)	{{c1::sofort}}	J’entrevis <b><u>aussitôt</u></b> une lueur, dans le mystère de sa pré- sence, et j’interrogeai brusquement : –    Tu viens donc d’une autre planète ? <br>
entrevis (entrevoir)	{{c1::Blick}}	J’<b><u>entrevis</u></b> aussitôt une lueur, dans le mystère de sa pré- sence, et j’interrogeai brusquement : –    Tu viens donc d’une autre planète ? <br>
ajouta (ajouter)	{{c1::hinzufügen}}	Puis il <b><u>ajouta</u></b> : –    Alors, toi aussi tu viens du ciel ! <br>
malheurs (malheur)	{{c1::Unglück}}	Je désire que l’on prenne mes <b><u>malheurs</u></b> au sérieux. <br>
éclat (éclat)	{{c1::scheinen}}	ça c’est drôle… Et le petit prince eut un très joli <b><u>éclat</u></b> de rire qui m’irrita beaucoup. <br>
modestement (modestement)	{{c1::bescheiden}}	tu es tombé du ciel ? –    Oui, fis-je <b><u>modestement</u></b>. –    Ah ! <br>
fier (fier)	{{c1::stolz}}	Et j’étais <b><u>fier</u></b> de lui apprendre que je volais. <br>
aperçut (apercevoir)	{{c1::sehen}}	Ainsi, quand il <b><u>aperçut</u></b> pour la première fois mon avion (je ne dessinerai pas mon avion, c’est un dessin beaucoup trop compliqué pour moi) il me demanda : –    Qu’est-ce que c’est que cette chose-là ? –    Ce n’est pas une chose. <br>
peu (peu)	{{c1::wenig}}	Ce sont des mots prononcés par hasard qui, <b><u>peu</u></b> à <b><u>peu</u></b>, m’ont tout révélé. <br>
révélé (révélé)	{{c1::aufgedeckt}}	Ce sont des mots prononcés par hasard qui, peu à peu, m’ont tout <b><u>révélé</u></b>. <br>
une (une)	{{c1::ein}}	J’entrevis aussitôt <b><u>une</u></b> lueur, dans le mystère de sa pré- sence, et j’interrogeai brusquement : –    Tu viens donc d’<b><u>une</u></b> autre planète ? <br>
prononcés (prononcer)	{{c1::aussprechen}}	Ce sont des mots <b><u>prononcés</u></b> par hasard qui, peu à peu, m’ont tout révélé. <br>
hasard (hasard)	{{c1::Gefahr}}	Ce sont des mots prononcés par <b><u>hasard</u></b> qui, peu à peu, m’ont tout révélé. <br>
