venait (venir)	Voilà le meilleur portrait que, plus tard, j’ai réussi à faire de lui CHAPITRE III Il me fallut longtemps pour comprendre d’où il <b><u>venait</u></b>. <br>
fallut (falloir)	Voilà le meilleur portrait que, plus tard, j’ai réussi à faire de lui CHAPITRE III Il me <b><u>fallut</u></b> longtemps pour comprendre d’où il venait. <br>
calcul (calcul)	Mon dessin numéro 2 était comme ça : Les grandes personnes m’ont conseillé de laisser de côté les dessins de serpents boas ouverts  ou  fermés, et de m’intéresser plutôt à la géographie, à l’histoire, au <b><u>calcul</u></b> et à la grammaire. <br>
fis (faire)	Il s’est endormi… Et c’est ainsi que je <b><u>fis</u></b> la connaissance du petit prince. <br>
bridge (bridge)	Je lui parlais de <b><u>bridge</u></b>, de golf, de politique et de cravates. <br>
expérience (expérience)	Quand  j’en  rencontrais  une  qui  me  paraissait  un  peu  lu- cide, je faisais l’<b><u>expérience</u></b> sur elle de mon dessin numéro 1 que j’ai  toujours  conservé.  <br>
habitée (habité)	Le premier soir je me suis donc endormi sur le sable à mille milles de toute terre <b><u>habitée</u></b>. <br>
puis (puis)	J’ai  alors  dessiné l’intérieur du serpent boa, afin que les grandes personnes <b><u>puis</u></b>- sent comprendre. <br>
bonhomme (bonhomme)	Et j’ai vu un petit <b><u>bonhomme</u></b> tout à fait extraordinaire qui me considérait gravement. <br>
peur (peur)	Il était comme ça : J’ai montré mon chef-d’œuvre aux grandes personnes et je leur ai demandé si mon dessin leur faisait <b><u>peur</u></b>. <br>
meilleur (meilleur)	1) Voilà le <b><u>meilleur</u></b> portrait que, plus tard, j’ai réussi à faire de lui CHAPITRE III Il me fallut longtemps pour comprendre d’où il venait. <br>2) Voilà le <b><u>meilleur</u></b> portrait que, plus tard, j’ai réussi à faire de lui. <br>
connaissance (connaissance)	Il s’est endormi… Et c’est ainsi que je fis la <b><u>connaissance</u></b> du petit prince. <br>
pencha (pencher)	Il <b><u>pencha</u></b> la tête vers le dessin : –    Pas si petit que ça… Tiens ! <br>
donné (donné)	Je t’ai <b><u>donné</u></b> un tout petit mouton. <br>
sûrement (sûrement)	Crois-tu qu’il faille beaucoup d’herbe à ce mouton ? –    Pourquoi ? –    Parce que chez moi c’est tout petit… –    Ça suffira <b><u>sûrement</u></b>. <br>
suffira (suffire)	Crois-tu qu’il faille beaucoup d’herbe à ce mouton ? –    Pourquoi ? –    Parce que chez moi c’est tout petit… –    Ça <b><u>suffira</u></b> sûrement. <br>
herbe (herbe)	Crois-tu qu’il faille beaucoup d’<b><u>herbe</u></b> à ce mouton ? –    Pourquoi ? –    Parce que chez moi c’est tout petit… –    Ça suffira sûrement. <br>
faille (faille)	Crois-tu qu’il <b><u>faille</u></b> beaucoup d’herbe à ce mouton ? –    Pourquoi ? –    Parce que chez moi c’est tout petit… –    Ça suffira sûrement. <br>
Crois (croire)	<b><u>Crois</u></b>-tu qu’il faille beaucoup d’herbe à ce mouton ? –    Pourquoi ? –    Parce que chez moi c’est tout petit… –    Ça suffira sûrement. <br>
lançai (lancer)	Et je <b><u>lançai</u></b> : –    Ça c’est la caisse. <br>
griffonnai (griffonner)	Alors, faute de patience, comme j’avais hâte de commencer le démontage de mon moteur, je <b><u>griffonnai</u></b> ce dessin-ci. <br>
commencer (commencer)	Alors, faute de patience, comme j’avais hâte de <b><u>commencer</u></b> le démontage de mon moteur, je griffonnai ce dessin-ci. <br>
hâte (hâte)	Alors, faute de patience, comme j’avais <b><u>hâte</u></b> de commencer le démontage de mon moteur, je griffonnai ce dessin-ci. <br>
vieux (vieux)	Il a des cornes… Je refis donc encore mon dessin : Mais il fut refusé, comme les précédents : –    Celui-là est trop <b><u>vieux</u></b>. <br>
précédents (précédent)	Il a des cornes… Je refis donc encore mon dessin : Mais il fut refusé, comme les <b><u>précédents</u></b> : –    Celui-là est trop vieux. <br>
encore (encore)	Il a des cornes… Je refis donc <b><u>encore</u></b> mon dessin : Mais il fut refusé, comme les précédents : –    Celui-là est trop vieux. <br>
bélier (bélier)	Je dessinai : Mon ami sourit gentiment, avec indulgence : –    Tu vois bien… ce n’est pas un mouton, c’est un <b><u>bélier</u></b>. <br>
vois (voir)	Je dessinai : Mon ami sourit gentiment, avec indulgence : –    Tu <b><u>vois</u></b> bien… ce n’est pas un mouton, c’est un bélier. <br>
indulgence (indulgence)	Je dessinai : Mon ami sourit gentiment, avec <b><u>indulgence</u></b> : –    Tu vois bien… ce n’est pas un mouton, c’est un bélier. <br>
sourit (sourire)	Je dessinai : Mon ami <b><u>sourit</u></b> gentiment, avec indulgence : –    Tu vois bien… ce n’est pas un mouton, c’est un bélier. <br>
malade (malade)	Celui-là est déjà très <b><u>malade</u></b>. <br>
attentivement (attentivement)	Il regarda <b><u>attentivement</u></b>, puis : –    Non ! <br>
besoin (besoin)	1) Elles ont toujours <b><u>besoin</u></b> d’explications. <br>2) J’ai <b><u>besoin</u></b> d’un mouton. <br>
stupéfait (stupéfait)	Et je fus <b><u>stupéfait</u></b> d’entendre le petit bonhomme me ré- pondre : –    Non ! <br>
entendre (entendre)	Et je fus stupéfait d’<b><u>entendre</u></b> le petit bonhomme me ré- pondre : –    Non ! <br>
fus (être)	Et je <b><u>fus</u></b> stupéfait d’entendre le petit bonhomme me ré- pondre : –    Non ! <br>
un (un)	Comme je n’avais jamais dessiné <b><u>un</u></b> mouton je refis, pour lui, l’<b><u>un</u></b> des deux seuls dessins dont j’étais capable. <br>
dont (dont)	Comme je n’avais jamais dessiné un mouton je refis, pour lui, l’un des deux seuls dessins <b><u>dont</u></b> j’étais capable. <br>
refis (refaire)	Comme je n’avais jamais dessiné un mouton je <b><u>refis</u></b>, pour lui, l’un des deux seuls dessins dont j’étais capable. <br>
mauvaise (mauvais)	Mais je me rappelai alors que j’avais surtout étudié la géographie, l’histoire, le calcul et la grammaire et je dis au petit bonhomme (avec un peu de <b><u>mauvaise</u></b> humeur) que je ne savais pas dessiner. <br>
surtout (surtout)	Mais je me rappelai alors que j’avais <b><u>surtout</u></b> étudié la géographie, l’histoire, le calcul et la grammaire et je dis au petit bonhomme (avec un peu de mauvaise humeur) que je ne savais pas dessiner. <br>
rappelai (rappeler)	Mais je me <b><u>rappelai</u></b> alors que j’avais surtout étudié la géographie, l’histoire, le calcul et la grammaire et je dis au petit bonhomme (avec un peu de mauvaise humeur) que je ne savais pas dessiner. <br>
stylographe (stylographe)	Aussi absurde que cela me semblât à mille milles de tous les endroits habités et en danger de mort, je sortis de ma poche une feuille de papier et un <b><u>stylographe</u></b>. <br>
feuille (feuille)	Aussi absurde que cela me semblât à mille milles de tous les endroits habités et en danger de mort, je sortis de ma poche une <b><u>feuille</u></b> de papier et un stylographe. <br>
sortis (sortir)	Aussi absurde que cela me semblât à mille milles de tous les endroits habités et en danger de mort, je <b><u>sortis</u></b> de ma poche une feuille de papier et un stylographe. <br>
endroits (endroit)	Aussi absurde que cela me semblât à mille milles de tous les <b><u>endroits</u></b> habités et en danger de mort, je sortis de ma poche une feuille de papier et un stylographe. <br>
semblât (sembler)	Aussi absurde que cela me <b><u>semblât</u></b> à mille milles de tous les endroits habités et en danger de mort, je sortis de ma poche une feuille de papier et un stylographe. <br>
ose (oser)	Et il me répéta alors, tout doucement, comme une ch<b><u>ose</u></b> très sérieuse : –    S’il vous plaît… dessine-moi un mouton… Quand le mystère est trop impressionnant, on n’<b><u>ose</u></b> pas dé- sobéir. <br>
impressionnant (impressionnant)	Et il me répéta alors, tout doucement, comme une chose très sérieuse : –    S’il vous plaît… dessine-moi un mouton… Quand le mystère est trop <b><u>impressionnant</u></b>, on n’ose pas dé- sobéir. <br>
Quand (quand)	Et il me répéta alors, tout doucement, comme une chose très sérieuse : –    S’il vous plaît… dessine-moi un mouton… <b><u>Quand</u></b> le mystère est trop impressionnant, on n’ose pas dé- sobéir. <br>
doucement (doucement)	Et il me répéta alors, tout <b><u>doucement</u></b>, comme une chose très sérieuse : –    S’il vous plaît… dessine-moi un mouton… Quand le mystère est trop impressionnant, on n’ose pas dé- sobéir. <br>
répéta (répéter)	Et il me <b><u>répéta</u></b> alors, tout doucement, comme une chose très sérieuse : –    S’il vous plaît… dessine-moi un mouton… Quand le mystère est trop impressionnant, on n’ose pas dé- sobéir. <br>
enfin (enfin)	Quand je réussis <b><u>enfin</u></b> à parler, je lui dis : –    Mais… qu’est-ce que tu fais là ? <br>
perdu (perdu)	Il n’avait en rien l’apparence d’un enfant <b><u>perdu</u></b> au milieu du désert, à mille milles de toute région habitée. <br>
soif (soif)	Or mon petit bonhomme ne me semblait ni égaré, ni mort de fatigue, ni mort de faim, ni mort de <b><u>soif</u></b>, ni mort de peur. <br>
égaré (égaré)	1) C’est très utile, si l’on est <b><u>égaré</u></b> pendant la nuit. <br>2) Or mon petit bonhomme ne me semblait ni <b><u>égaré</u></b>, ni mort de fatigue, ni mort de faim, ni mort de soif, ni mort de peur. <br>
semblait (sembler)	Or mon petit bonhomme ne me <b><u>semblait</u></b> ni égaré, ni mort de fatigue, ni mort de faim, ni mort de soif, ni mort de peur. <br>
Or (or)	<b><u>Or</u></b> mon petit bonhomme ne me semblait ni égaré, ni mort de fatigue, ni mort de faim, ni mort de soif, ni mort de peur. <br>
étonnement (étonnement)	Je regardai donc cette apparition avec des yeux tout ronds d’<b><u>étonnement</u></b>. <br>
ronds (rond)	Je regardai donc cette apparition avec des yeux tout <b><u>ronds</u></b> d’étonnement. <br>
apparition (apparition)	Je regardai donc cette <b><u>apparition</u></b> avec des yeux tout ronds d’étonnement. <br>
sauf (sauf)	J’avais été décou- ragé dans ma carrière de peintre par les grandes personnes, à l’âge de six ans, et je n’avais rien appris à dessiner, <b><u>sauf</u></b> les boas fermés et les boas ouverts. <br>
appris (apprendre)	1) J’ai donc dû choisir un autre métier et j’ai <b><u>appris</u></b> à piloter des avions. <br>2) J’avais été décou- ragé dans ma carrière de peintre par les grandes personnes, à l’âge de six ans, et je n’avais rien <b><u>appris</u></b> à dessiner, sauf les boas fermés et les boas ouverts. <br>
vissant (visser)	1) Mais mon dessin, bien sûr, est beaucoup moins ra- <b><u>vissant</u></b> que le modèle. <br>2) Mais mon dessin, bien sûr, est beaucoup moins ra- <b><u>vissant</u></b> que le modèle. <br>
moins (moins)	Mais mon dessin, bien sûr, est beaucoup <b><u>moins</u></b> ra- vissant que le modèle. <br>
lui (lui)	Voilà le meilleur portrait que, plus tard, j’ai réussi à faire de <b><u>lui</u></b>. <br>
tard (tard)	Voilà le meilleur portrait que, plus <b><u>tard</u></b>, j’ai réussi à faire de lui. <br>
gravement (gravement)	Et j’ai vu un petit bonhomme tout à fait extraordinaire qui me considérait <b><u>gravement</u></b>. <br>
considérait (considérer)	Et j’ai vu un petit bonhomme tout à fait extraordinaire qui me <b><u>considérait</u></b> gravement. <br>
tout à fait (tout à fait)	Et j’ai vu un petit bonhomme <b><u>tout à fait</u></b> extraordinaire qui me considérait gravement. <br>
frotté (frotter)	J’ai bien <b><u>frotté</u></b> mes yeux. <br>
foudre (foudre)	Elle disait : –    S’il vous plaît… dessine-moi un mouton ! –    Hein ! –    Dessine-moi un mouton… J’ai sauté sur mes pieds comme si j’avais été frappé par la <b><u>foudre</u></b>. <br>
frappé (frappé)	Elle disait : –    S’il vous plaît… dessine-moi un mouton ! –    Hein ! –    Dessine-moi un mouton… J’ai sauté sur mes pieds comme si j’avais été <b><u>frappé</u></b> par la foudre. <br>
sauté (sauté)	Elle disait : –    S’il vous plaît… dessine-moi un mouton ! –    Hein ! –    Dessine-moi un mouton… J’ai <b><u>sauté</u></b> sur mes pieds comme si j’avais été frappé par la foudre. <br>
réveillé (réveiller)	Alors vous imaginez ma surprise, au lever du jour, quand une drôle de petite voix m’a <b><u>réveillé</u></b>. <br>
milieu (milieu)	J’étais bien plus isolé qu’un nau- fragé sur un radeau au <b><u>milieu</u></b> de l’Océan. <br>
radeau (radeau)	J’étais bien plus isolé qu’un nau- fragé sur un <b><u>radeau</u></b> au milieu de l’Océan. <br>
donc (donc)	1) J’ai <b><u>donc</u></b> dû choisir un autre métier et j’ai appris à piloter des avions. <br>2) Le premier soir je me suis <b><u>donc</u></b> endormi sur le sable à mille milles de toute terre habitée. <br>
sable (sable)	Le premier soir je me suis donc endormi sur le <b><u>sable</u></b> à mille milles de toute terre habitée. <br>
endormi (endormi)	Le premier soir je me suis donc <b><u>endormi</u></b> sur le sable à mille milles de toute terre habitée. <br>
peine (peine)	J’avais à <b><u>peine</u></b> de l’eau à boire pour huit jours. <br>
avais (avoir)	Et comme je n’<b><u>avais</u></b> avec moi ni mécanicien, ni passagers, je me préparai à essayer de réussir, tout seul, une réparation difficile. <br>
passagers (passager)	Et comme je n’avais avec moi ni mécanicien, ni <b><u>passagers</u></b>, je me préparai à essayer de réussir, tout seul, une réparation difficile. <br>
cassé (cassé)	Quelque chose s’était <b><u>cassé</u></b> dans mon moteur. <br>
vécu (vécu)	1) J’ai beaucoup <b><u>vécu</u></b> chez les grandes per- sonnes. <br>2) CHAPITRE II J’ai ainsi <b><u>vécu</u></b> seul, sans personne avec qui parler vérita- blement, jusqu’à une panne dans le désert du Sahara, il y a six ans. <br>
réussir (réussir)	Et comme je n’avais avec moi ni mécanicien, ni passagers, je me préparai à essayer de <b><u>réussir</u></b>, tout seul, une réparation difficile. <br>
essayer (essayer)	Et comme je n’avais avec moi ni mécanicien, ni passagers, je me préparai à <b><u>essayer</u></b> de réussir, tout seul, une réparation difficile. <br>
préparai (préparer)	Et comme je n’avais avec moi ni mécanicien, ni passagers, je me <b><u>préparai</u></b> à essayer de réussir, tout seul, une réparation difficile. <br>
vierges (vierge)	» Alors je ne lui parlais ni de serpents boas, ni de fo- rêts <b><u>vierges</u></b>, ni d’étoiles. <br>
portée (portée)	Je me mettais à sa <b><u>portée</u></b>. <br>
mettais (mettre)	Je me <b><u>mettais</u></b> à sa portée. <br>
paraissait (paraître)	Quand  j’en  rencontrais  une  qui  me  <b><u>paraissait</u></b>  un  peu  lu- cide, je faisais l’expérience sur elle de mon dessin numéro 1 que j’ai  toujours  conservé.  <br>
vues (vu)	Je les ai <b><u>vues</u></b> de très près. <br>
amélioré (améliorer)	Ça n’a pas trop <b><u>amélioré</u></b> mon opinion. <br>
près (près)	Je les ai vues de très <b><u>près</u></b>. <br>
tas (tas)	J’ai ainsi eu, au cours de ma vie, des <b><u>tas</u></b> de contacts avec des <b><u>tas</u></b> de gens sérieux. <br>
cours (cours)	J’ai ainsi eu, au <b><u>cours</u></b> de ma vie, des tas de contacts avec des tas de gens sérieux. <br>
reconnaître (reconnaître)	Je savais <b><u>reconnaître</u></b>, du premier coup d’œil, la Chine de l’Arizona. <br>
savais (savoir)	Je <b><u>savais</u></b> reconnaître, du premier coup d’œil, la Chine de l’Arizona. <br>
servi (servi)	Et la géo- graphie, c’est exact, m’a beaucoup <b><u>servi</u></b>. <br>
partout (partout)	J’ai volé un peu <b><u>partout</u></b> dans le monde. <br>
volé (voler)	J’ai <b><u>volé</u></b> un peu partout dans le monde. <br>
piloter (piloter)	J’ai donc dû choisir un autre métier et j’ai appris à <b><u>piloter</u></b> des avions. <br>
ainsi (ainsi)	C’est <b><u>ainsi</u></b> que j’ai abandonné, à l’âge de six ans, une magnifique carrière de peintre. <br>
côté (côté)	Mon dessin numéro 2 était comme ça : Les grandes personnes m’ont conseillé de laisser de <b><u>côté</u></b> les dessins de serpents boas ouverts  ou  fermés, et de m’intéresser plutôt à la géographie, à l’histoire, au calcul et à la grammaire. <br>
conseillé (conseillé)	Mon dessin numéro 2 était comme ça : Les grandes personnes m’ont <b><u>conseillé</u></b> de laisser de côté les dessins de serpents boas ouverts  ou  fermés, et de m’intéresser plutôt à la géographie, à l’histoire, au calcul et à la grammaire. <br>
toujours (toujours)	Elles ont <b><u>toujours</u></b> besoin d’explications. <br>
sent (sentir)	J’ai  alors  dessiné l’intérieur du serpent boa, afin que les grandes personnes puis- <b><u>sent</u></b> comprendre. <br>
afin que (afin)	J’ai  alors  dessiné l’intérieur du serpent boa, <b><u>afin que</u></b> les grandes personnes puis- sent comprendre. <br>
afin (afin)	J’ai  alors  dessiné l’intérieur du serpent boa, <b><u>afin</u></b> que les grandes personnes puis- sent comprendre. <br>
alors (alors)	J’ai  <b><u>alors</u></b>  dessiné l’intérieur du serpent boa, afin que les grandes personnes puis- sent comprendre. <br>
dessiné (dessiné)	J’ai  alors  <b><u>dessiné</u></b> l’intérieur du serpent boa, afin que les grandes personnes puis- sent comprendre. <br>
intérieur (intérieur)	J’ai  alors  dessiné l’<b><u>intérieur</u></b> du serpent boa, afin que les grandes personnes puis- sent comprendre. <br>
ferait (faire)	Elles m’ont répondu : « Pourquoi un chapeau  <b><u>ferait</u></b>-il  peur ? <br>
œuvre (œuvre)	Il était comme ça : J’ai montré mon chef-d’<b><u>œuvre</u></b> aux grandes personnes et je leur ai demandé si mon dessin leur faisait peur. <br>
tracer (tracer)	» J’ai  alors  beaucoup  réfléchi  sur  les  aventures  de  la  jungle et,  à  mon  tour,  j’ai  réussi,  avec  un  crayon  de  couleur,  à  <b><u>tracer</u></b> mon premier dessin. <br>
réussi (réussi)	» J’ai  alors  beaucoup  réfléchi  sur  les  aventures  de  la  jungle et,  à  mon  tour,  j’ai  <b><u>réussi</u></b>,  avec  un  crayon  de  couleur,  à  tracer mon premier dessin. <br>
réfléchi (réfléchi)	» J’ai  alors  beaucoup  <b><u>réfléchi</u></b>  sur  les  aventures  de  la  jungle et,  à  mon  tour,  j’ai  réussi,  avec  un  crayon  de  couleur,  à  tracer mon premier dessin. <br>
bouger (bouger)	Ensuite ils ne peuvent plus <b><u>bouger</u></b> et ils dorment pendant les six mois de leur digestion. <br>
peuvent (pouvoir)	Ensuite ils ne <b><u>peuvent</u></b> plus bouger et ils dorment pendant les six mois de leur digestion. <br>
entière (entier)	On disait dans le livre : « Les serpents boas avalent leur proie tout <b><u>entière</u></b>, sans la mâcher. <br>
Ensuite (ensuite)	<b><u>Ensuite</u></b> ils ne peuvent plus bouger et ils dorment pendant les six mois de leur digestion. <br>
mâcher (mâcher)	On disait dans le livre : « Les serpents boas avalent leur proie tout entière, sans la <b><u>mâcher</u></b>. <br>
proie (proie)	On disait dans le livre : « Les serpents boas avalent leur <b><u>proie</u></b> tout entière, sans la mâcher. <br>
dessin (dessin)	Voilà la copie du <b><u>dessin</u></b>. <br>
boa (boa)	Ça représentait un serpent <b><u>boa</u></b> qui avalait un fauve. <br>
copie (copie)	Voilà la <b><u>copie</u></b> du dessin. <br>
fauve (fauve)	Ça représentait un serpent boa qui avalait un <b><u>fauve</u></b>. <br>
avalait (avaler)	Ça représentait un serpent boa qui <b><u>avalait</u></b> un fauve. <br>
pieds (pied)	Je réalisai que j’avais dormi avec mes baskets aux <b><u>pieds</u></b>, ce qui était finalement parfait. —  Ils.. ils… Il bégayait. <br>
courant (courant)	Alex arriva en <b><u>courant</u></b> vers moi. <br>
grimaçai (grimacer)	Je <b><u>grimaçai</u></b> sous le bruit. <br>
sous (sous)	Je grimaçai <b><u>sous</u></b> le bruit. <br>
bruit (bruit)	Je grimaçai sous le <b><u>bruit</u></b>. <br>
forts (fort)	Les cris reprirent, plus proches, plus <b><u>forts</u></b>, plus aigus. <br>
aigus (aigu)	Les cris reprirent, plus proches, plus forts, plus <b><u>aigus</u></b>. <br>
reprirent (reprendre)	Les cris <b><u>reprirent</u></b>, plus proches, plus forts, plus aigus. <br>
néanmoins (néanmoins)	Elle me resta dans la main mais s’ouvrit <b><u>néanmoins</u></b>. <br>
la (la)	Je m’en extirpai, atteignis l’entrée de <b><u>la</u></b> tente, attrapai <b><u>la</u></b> fermeture éc<b><u>la</u></b>ir et <b><u>la</u></b> tirai. <br>
main (main)	Elle me resta dans la <b><u>main</u></b> mais s’ouvrit néanmoins. <br>
resta (rester)	Elle me <b><u>resta</u></b> dans la main mais s’ouvrit néanmoins. <br>
tirai (tirer)	Je m’en extirpai, atteignis l’entrée de la tente, attrapai la fermeture éclair et la <b><u>tirai</u></b>. <br>
éclair (éclair)	Je m’en extirpai, atteignis l’entrée de la tente, attrapai la fermeture <b><u>éclair</u></b> et la tirai. <br>
fermeture éclair (fermeture éclair)	Je m’en extirpai, atteignis l’entrée de la tente, attrapai la <b><u>fermeture éclair</u></b> et la tirai. <br>
fermeture (fermeture)	Je m’en extirpai, atteignis l’entrée de la tente, attrapai la <b><u>fermeture</u></b> éclair et la tirai. <br>
attrapai (attraper)	Je m’en extirpai, atteignis l’entrée de la tente, <b><u>attrapai</u></b> la fermeture éclair et la tirai. <br>
atteignis (atteindre)	Je m’en extirpai, <b><u>atteignis</u></b> l’entrée de la tente, attrapai la fermeture éclair et la tirai. <br>
extirpai (extirper)	Je m’en <b><u>extirpai</u></b>, atteignis l’entrée de la tente, attrapai la fermeture éclair et la tirai. <br>
sac de couchage (sac de couchage)	Je me levai en sursaut, empêtrée dans mon <b><u>sac de couchage</u></b>. <br>
sursaut (sursaut)	Je me levai en <b><u>sursaut</u></b>, empêtrée dans mon sac de couchage. <br>
réveillèrent (réveiller)	 KACY Des cris stridents déchirèrent l’air et me <b><u>réveillèrent</u></b> immédiatement. <br>
déchirèrent (déchirer)	 KACY Des cris stridents <b><u>déchirèrent</u></b> l’air et me réveillèrent immédiatement. <br>
